00000000000000000 2
0     0   0        
0 000 0 000 0 000 0
0 0   0     0   0 0
0 0 00000 00000 0 0
0     0       0   0
0000000 0000000 000
0       0          
0000000000000000000
